################
#M............m#
#..............#
#..............#
#..............#
#..............#
#..............#
#..............#
#..............#
#..............#
#M............m#
#######||#######