#######||#######
#M...........+m#
#..*.........+.#
#.....BBB......#
#.....BMB......#
#.....BBB......#
#.....+++......#
#..............#
#..*.....*.....#
#BB............#
#MB...........m#
#######||#######