################
#..............#
#.+..........+.#
#..............#
#..............#
#......*.......|
#..............|
#..............#
#..............#
#.+..........+.#
#..............#
################