#######||#######
#..............#
#.+..........+.#
#..............#
#..............#
#..............#
#..............#
#..............#
#..............#
#.+..........+.#
#..............#
################