################
#..............#
#.*..........*.#
#..............#
#..............#
|......+.......#
|..............#
#..............#
#..............#
#.*..........*.#
#..............#
################