################
#..............#
#..*........*..#
#.***......***.#
#..*........*..#
#..............#
#..............#
#..*........*..#
#.***......***.#
#..*........*..#
#..............#
#######||#######