################
#..............#
#.*..........*.#
#..............#
#..............#
|......++......#
|......++......#
#..............#
#..............#
#.*..........*.#
#..............#
################