################
#..............#
#..............#
#..............#
#..............#
#..............|
#..............|
#..............#
#..............#
#..............#
#..............#
################