#######||#######
#..............#
#.........B....#
#..............#
#..............#
|..............|
|..............|
#..............#
#..............#
#..............#
#..............#
#######||#######