################
#..............#
#..............#
#..............#
#..............#
|..............#
|..............#
#..............#
#..............#
#..............#
#..............#
################