################
#..............#
#.*.........*..#
#..............#
#..............#
#......**......#
#......**......#
#..............#
#..............#
#.*.........*..#
#..............#
#######||#######