################
#..............#
#.*.........*..#
#..............#
#..............#
#..............#
#..............#
#..............#
#..............#
#.*.........*..#
#..............#
#######||#######