################
#..............#
#.+..........+.#
#..............#
#..............#
#......**......|
#......**......|
#..............#
#..............#
#.+..........+.#
#..............#
################