################
#*............m#
#..............#
#..............#
#..............#
#..............#
#..............#
#..............#
#..............#
#..............#
#+............B#
#######||#######