#######||#######
#..............#
#.+..........+.#
#..............#
#..............#
#......++......#
#......++......#
#..............#
#..............#
#.+..........+.#
#..............#
################